LN=Level 1
GD=300
ET=3
ED=2
ER=1
RS=1
PR=5
PO=10
MP=3
MAP:13,19
W-2----R-----W----R
--W--W----------W-1
W-R-------R--------
-----W--W---W-----R
-W----R-------R----
-------------------
---------W--------W
W-W-W-W-W-W-WRW-W-W
----W---R---R3R--W-
------W---W-----W--
-------------------
--R--R--W---W-R--W-
----------W------E-