LN=Level 4
GD=300
ET=10
ED=8
ER=10
RS=1
PR=5
PO=10
MP=3
MAP:15,10
-E------1-
-R-R-R-R-R
-E--W-----
-R-R-R-R-R
-----E---W
-R-R-R-R-R
-E---E----
-R-R-R-R-R
---W-----W
-R-R-R-R-R
----E-----
3R-R-RER-R
----------
-R-R-R-R-R
---W---E--