LN=3
GD=120
ET=1
ED=1
ER=3
RS=2
PR=10
PO=100
MP=4
MAP:11,17
--W--------W-E--3
RWR-R-R-R-R-R-R-R
-WWWW---1-------W
RWRWRWRWR-R-R-R-R
-2-----E----W----
RWR-R-R-R-R-R-R-R
-W--------E------
RWRWR-R-R-R-RWR-R
--WWWW--E--WWW---
R-R-RWRWR-RWRWRWR
-----4WWW--WW---E
