LN=Level 4
GD=300
ET=10
ED=8
ER=10
RS=1
PR=5
PO=10
MP=3
MAP:15,10
--------1-
-R-R-R-R-R
----W-----
-R-R-R-R-R
---------W
-R-R-R-R-R
----------
-R-R-R-R-R
---W-----W
-R-R-R-R-R
----------
3R-R-R-R-R
----------
-R-R-R-R-R
---W------