LN=2
GD=120
ET=1.5
ED=1
ER=3
RS=1
PR=10
PO=100
MP=4
MAP:11,17
-2-----E----W----
RWR-R-R-R-R-R-R-R
-W--W-----E------
RWRWR-R-R-R-RWR-R
--W-----1--W-E--3
R-R-R-R-R-R-R-R--
--W-W--W--W-W---W
RWR-RWRWR-R-R-R-R
--W-WW--E---R----
R-RERWRWR-RWRWRWR
4------EWW-W-W-WE
