LN=1
GD=120
ET=2
ED=2
ER=4
RS=0.5
PR=10
PO=100
MP=3
MAP:11,17
-2-----E----W----
RWR-R-R-R-R-R-R-R
-W--------E------
RWRWR-R-R-R-RWR-R
--W--------W-E--3
RWR-R-R-R-R-R-R-R
-WWWW---1-------W
RWRWRWRWR-R-R-R-R
--WWWW--E--WWW---
R-R-RWRWR-RWRWRWR
------WWW--WWW-WE
